#######
#   # #
### # #
#     #
### # #
#   # #
#######
--
#######
# # # #
# # # #
#     #
##### #
#     #
#######
--
#######
#   # #
# ### #
# #   #
# # ###
#     #
# #####
#     #
#######
--
#######
#     #
##### #
# #   #
# # ###
# # # #
#   # #
# #   #
#######
--
#########
#       #
##### ###
#   #   #
# ##### #
#       #
# ### ###
# #     #
#########
--
#########
#   #   #
# ##### #
#       #
####### #
# # #   #
# # ### #
#       #
#########
